10.ox
......oooo
........oo
.o..oo....
..o..o....
o...o.....
.....oo...
..oo..o...
..o.......
o..o...oo.
..oo......
