20.ox
..o..oo.oo.o........
.......oo..o.......o
..o....o....o..o....
........o.o..oo....o
o............o.....o
o.......oooo....o...
.................o..
.oo....o..........oo
.o.o..ooo.o..o..o...
.o.....o.o.oo...o...
.....o...ooo.o..oooo
.........o.........o
..o....o....o..oo..o
o.......o.o.o...oo..
...o..o..........o..
.ooo.oo....o..o..oo.
...ooooo...o...o.ooo
........oo..oo......
.......oo......o...o
.o...o..oo...o......
